################
#..............#
#.@............#
#..............#
#..............#
#..............#
################