##########################################
#........................................#
#........................................#
#..................@.....................#
#........................................#
#........................................############
#...............########............................#
#...................................................#
#..............................................*....#
#...................................................#
#...................................................#
#.###################################################
#*#
#.###################
#...................#
#.........*.........#
#...................#
#####################
